

               	NO text/anis.xpm
            

WE 		text/arepa.xpm
    SO      text/fcb.xpm

         F 23,43,233

EA          text/cachapa.xpm

C 			22               ,      244                    ,253
111111
100101
101001
1100N1
111111















