NO text/bluestone.xpm
WE text/greystone.xpm
SO text/purplestone.xpm
EA text/colorstone.xpm

F 121,49,200
C 212,67,77

11111111111111111111111111111111
10000000000000000000000000000001
10000000000000000000000000000001
10000000000000000000000000000001
10000000000000000000000000000001
10000000000000000000000000000001
10000000000000000000000000000001
10000000000000000000000000000001
10000000000001000000000000000001
1000000000001 100S00000000000001
10000000000001000000000000000001
10000000000000000000000000000001
10000000000000000000000000000001
100000000000000000000000000000011111111111111111111111111
111111111111111111111100000000000000000000000000000111111
111111111111111111111111111111000000000000000000000111111
111111111111111111111111111111111111000000000000000000111
                                    100000000000000000111
                                    100000000000000000111
                                    100000000000000000111
                                    100000000000000000111
                                    100000000000000000111
                                    100000000000000000111
                                    100000000000000000111
                                    100000000000000000111
                                    100000000000000000111
                                    100000000000000000111
                                    100000000000000000111
                                    100000000000000000111
                                    100000000000000000111
                                    100000000000000000111
                                    100000000000000000111
                                    100000000000000000111
                                    100000000000000000111
                                    111111111111111111111

